1111111111111
1001C0000C001
1000C11111111
10P01100001E1
1111111111111