1111111111111
1001C0000C001
1000C11111101
10P0110000101
1111111111111